[1] # Version Number

11 # Width
11 # Height
00000000000
00000000000
00000000000
00000000000
00022211000
00022211000
00011111000
00011111000
00000000000
00000000000
00000000000
